6 13 31
###############################
# #             #             #
#  #     #     #  #   #     # #
#    #  #  #  #   #   #  #  # #
#      #     #    #   #     # #
#                             #
#                             #
#        ###############      #
#                             #
#                             #
#                             #
#                             #
###############################